;Russian Locale, version 0.1
;Common
FileCommanderVer=Файловый менеджер {0}, версия {1}{n}© 2013-15 Группа разработки {0}:{2}{n}{n}Условия лицензирования см. в файле LICENSE.{n}О взятом из других открытых проектов см. в файле COPYPASTE.md.{n}{n}Файл настроек: {3}{n}{n}ОС: {4}{n}Framework: {5}
FCVEVer1=Встроенный просмоторщик и редактор файлов FC {0}.
FCVEVer2=Загружен модуль просмотра: {0}, версия {1}.{2}(C) 2013-15, разработчики FC и {3}
LocalFSVer=Модуль доступа к локальным ФС [встроенный]
VEptxtVer=Простой текст
;Main window keyboard help
FCF1=Справка
FCF2=Меню
FCF3=Чтение
FCF4=Правка
FCF5=Копия
FCF6=Перенос
FCF7=Каталог
FCF8=Удал-е
FCF9=Оп-ции
FCF10=Выход
;Main window menu
FCmnuFile=_Файл
FCmnuView=_Вид
FCmnuNav=_Навигация
FCmnuTools=С_ервис
FCmnuHelp=_Справка
FCmnuFileUserMenu=Меню пользователя
FCmnuFileView=Просмотреть файл
FCmnuFileEdit=Редактировать файл
FCmnuFileCompare=Сравнить файлы
FCmnuFileCopy=Копирование
FCmnuFileMove=Перенос/переименование
FCmnuFileNewDir=Новый каталог
FCmnuFileRemove=Удалить
FCmnuFileAtributes=Свойства...
FCmnuFileQuickSelect=Выделить группу...
FCmnuFileQuickUnselect=Снять выделение группы...
FCmnuFileSelectAll=Выделить всё
FCmnuFileUnselect=Снять выделение
FCmnuFileInvertSelection=Инвертировать выделение
FCmnuFileExit=Выxод
FCmnuViewShort=Краткий (список)
FCmnuViewDetails=Полный (таблица)
FCmnuViewIcons=Иконки (значки)
FCmnuViewThumbs=Эскизы изображений
FCmnuViewQuickView=Быстрый просмотр выделенного в сосед. панели
FCmnuViewTree=Древо каталогов
FCmnuViewPCPCconnect=Прямая связь ПК-ПК
FCmnuViewPCNETPCconnect=Мини HTTP сервер
FCmnuViewByName=По имени
FCmnuViewByType=По расширению
FCmnuViewByDate=По дате
FCmnuViewBySize=По размеру
FCmnuViewNoFilter=Без фильтра (*.*)
FCmnuViewWithFilter=Применить фильтр имени...
FCmnuViewToolbar=Панель инструментов
FCmnuViewKeybrdHelp=Подсказки клавиш F
FCmnuViewInfobar=Сводные строки
FCmnuViewDiskButtons=Кнопки дисков
FCmnuNavigateTree=Дерево
FCmnuNavigateFind=Розыск файла...
FCmnuNavigateHistory=История посещений
FCmnuNavigateReload=Перезагрузить
FCmnuToolsOptions=Настройки...
FCmnuToolsPluginManager=Управление расширениями...
FCmnuToolsEditUserMenu=Редактировать меню пользователя...
FCmnuToolsConfigEdit=Правка конфигурации FC
FCmnuToolsKeychains=Учётные данные ФС
FCmnuToolsDiskLabel=Метка диска...
FCmnuToolsFormat=Форматировать носитель...
FCmnuToolsSysInfo=Сведения о системе
FCmnuHelpHelpMe=Справка File Commander
FCmnuHelpDebug=Отладка Файло-Коммандера
FCmnuHelpAbout=О программе...
;Main window file listing panel column headers
FName=Имя
FSize=Размер
FDate=Дата
;Errors & strings for dialog windows
FCDelAsk=Вы действительно хотите удалить файл "{0}"?
Canceled=Отменено пользователем
Okay=ОК
Cancel=Отмена
FileNotFound=Файл "{0}" не найден
ItsDir="{0}" является каталогом
DirCantBeRemoved=Нет возможности удалить {0}
CantRead=Не читается: {0}.{1}
CantWrite=Не пишется: {0}.{1}
CantCopy=Ошибка копирования {0}: {1}
CantCopySelf=Нельзя копировать файл самого в себя!
CantMove=Ошибка перемещения/переименования {0}: {1}
CantRunEXE=Ошибка запуска внешней программы: 
ThemeNotFound=Не найден файл пользовательской темы
FileProgressDialogTitle=File Commander
DoingRemove=Выполняется удаление:{0}{1}
DoingCopy=Выполняется копирование: {0}{n}в {1}{n}{2}
CopyStatus={0} КБ из {1} КБ ({2}%)
DoingMkdir=Создаётся каталог:{0}{1}
DoingListdir=Чтение каталога:{0}{1}...
Directory=Каталог
Completed=Операция завершена успешно.
CopyTo=Введите путь для копирования {0}:
MoveTo=Перенести/переименовать {0} в:
NewDirURL=Введите путь для нового каталога
NewDirTemplate=\\НОВЫЙ КАТАЛОГ
NameFilterQuestion=Укажите шаблон имён файлов (пример, *.bat или e*.exe)
NameFilterFound=Поиск {0}: найдено {1} совпадений
NameFilterUseRegExp=_Регулярное выражение
NameFilterError=Ошибка поиска! Проверьте запрос
QuickSelect=Укажите шаблон имён для выделения (например, *.bat или e*.exe)
QuickUnselect=Укажите шаблон имён для снятия выделения (например, *.bat или e*.exe)
;Viewer/Editor (VE)
FCVTitle=Просмотр - {0}
FCETitle=Редактор - {0}
;VE keyboard help
FCVE_F1=Справка
FCVE_F2=
FCVE_F3=
FCVE_F4=Вид
FCVE_F5=Обновить
FCVE_F6=
FCVE_F7=Поиск
FCVE_F8=Формат
FCVE_F9=
FCVE_F10=Выход
;VE menus
FCVE_mnuFile=_Файл
FCVE_mnuFileNew=Созд_ать
FCVE_mnuFileOpen=_Открыть
FCVE_mnuFileReload=Пере_загрузить
FCVE_mnuFileSave=_Сохранить
FCVE_mnuFileSaveAs=Со_хранить как...
FCVE_mnuFilePrint=_Печать
FCVE_mnuFilePrintPreview=Пред_варительный просмотр...
FCVE_mnuFilePrintSettings=Пара_метры страницы...
FCVE_mnuFileClose=В_ыход
FCVE_mnuEdit=_Правка
FCVE_mnuEditCut=_Вырезать
FCVE_mnuEditCopy=_Копировать
FCVE_mnuEditPaste=Вст_авить
FCVE_mnuEditSelAll=_Выделить всё
FCVE_mnuEditSearch=_Найти...
FCVE_mnuEditSearchNext=Искать дальше
FCVE_mnuView=_Вид
FCVE_mnuViewModeText=_Простой текст
FCVE_mnuViewModeImage=_Рисунок
FCVE_mnuFormat=_Формат
FCVE_mnuHelp=_Справка
FCVE_mnuHelpHelpme=_Вызов справки
FCVE_mnuHelpAbout=_О программе и модуле просмотра
;VE dialog windows
FCVWhatFind=Введите искомую строку
FCVNothingFound=Запрошенный текст в файле не найден
FCVELoadingMsg=Загружается файл: {0} ...
FCVE_mnuViewSettings=Параметры...
FCVEpluginro1=Модуль просмотра {0} не поддерживает редактирование файлов
FCVEpluginro2=Файл будет открыт в режиме чтения.
FCVE_PluginNotFound=Не найден модуль для открытия этого файла. Файл будет выведен как текст.
FCVE_LoadError=Ошибка загрузки файла: {0}
FCVES_Title=Настройки просмоторщика/редактора
FCVES_ShowToolbar=Показывать _верхнюю панель (как в FAR)
FCVES_ShowCmdBar=Показывать _коммандную строку
;"Settings" window
FCS_Title=Настройки File Commander
FCS_CantSaveSettings=Невозможно сохранить настройки. Проверьте введённые данные.
swtMainWindow=Вид основного окна
swtViewerEditor=Правка/просмотр
swtFileNamesFont=Шрифт списка файлов
swtFonts=Шрифты
SWTMWtoolbar=Панель инструментов
SWTMWdiskbuttons=Кнопки дисков
SWTMWdisklistbox=Окно выбора диска
SWTMWpaneltitle=Заголовок файловой панели (с текущим путём)
SWTMWtablecolumns=Заголовки столбцов
SWTMWinfobar=Строки состояния
SWTMWcmdline=Коммандная строка
SWTMWkeybhelp=Подсказка клавиатуры (клавиш F)
SWTMWbookmars=Файл закладок:
SWTMWlanguage=Язык:
SWTVEviewer=Просмотр по F3
SWTVEinternalv=Встроенный просмоторщик
SWTVEexternalv=Внешний просмоторщик:
SWTVEvesetup=Настройка встроенной программы...
SWTVEeditor=Редактор по F4
SWTVEinternaleditor=Встроенный редактор
SWTVEexternaleditor=Внешний редактор:
swtMainWindowColumns=Столбцы панелей
SWTMWCFileExtView=Показывать типы (расширения) файлов:
SWTMWCExtTogether=Сразу после имени
SWTMWCExtFar=Отдельно
SWTMWCColumns=Столбцы
SWTMWCExt=Расширение
SWTMWCSize=Pазмер
SWTMWCDate=Изменено
SWTMWCFileMode=Доступ
SWTMWCExpandName=Расширить столбец "Имя"
SWTMWCShowCentury=Показывать век в дате (20хх)
SWTMWCShowTimeAs12h=12-часовой формат времени (AM/PM)
SWTMWCShowDirsInStatus=Выводить внизу кол-во папок
SWTMWCSizeDisplay=Размер в панелях
SizeDisplayPolicy000=в байтах
SizeDisplayPolicy100=в КБ (округлённо)
SizeDisplayPolicy200=в КБ (2 знака)
SizeDisplayPolicy111=плавающий (x.x К/М/Г)
SizeDisplayPolicy222=плавающий (x.xx К/М/Г)
SizeDisplayPolicy110=плавающий (x.x К/М)
SizeDisplayPolicy220=плавающий (x.xx K/M)
SWTMWinfobar=Информационная строка
SWTMWItext1=Текст, когда нет выделенных файлов:
SWTMWItext2=Текст, когда выделены файлы:
SWTMWIhelp=Допускается использование масок.{n}Допустимые маски для подстановки значений:{n}{FullName} - полное имя файла: filename.ext{n}{AutoSize} - размер файла: 18 KB{n}{Date} - дата изменения файла: 01.01.1970{n}{Time} - время изменения файла: 00:00:00{n}{SelectedItems} - сколько строк выделено{n}{n}
swtMainWindowThemes=Темы оформления
SWTMWTusethemes=Использовать тему оформления:
ReplaceQDTitle=Обнаружен конфликт имён файлов
ReplaceQDText=Существует одноимённый файл {0}. Выберите действие:
ReplaceQDReplace=Заменить
ReplaceQDReplaceAll=Заменить все
ReplaceQDSkip=Пропустить
ReplaceQDSkipAll=Пропустить все
ReplaceQDReplaceOld=Заменять устаревшие
ReplaceQDCompare=Сравнить